1,2,2,2,3,2,2,4
1,1,1,2,3,3,2,4
2,2,2,2,2,3,2,4
5,5,5,2,2,2,2,4
5,2,2,2,2,2,2,2
2,2,2,2,6,2,2,7
8,8,2,6,6,2,7,7
8,8,2,6,2,2,2,7
