1,1,2,2,2,3,3,3
1,4,2,4,2,5,3,3
1,4,2,4,2,3,3,3
1,4,4,4,2,6,7,3
1,4,4,4,2,6,7,7
1,4,8,4,2,6,7,7
8,4,8,4,2,6,6,7
8,8,8,8,7,7,7,7
